30
30
111111111111111111111111111111
101000001111000001000000000001
100001110010100000111111001111
100110000100111000000010000011
101001110000001000011111000111
100000000111110001100010000001
101110000100010000000000000011
100110000100111000000010000011
101001110000001000010011000111
100000000111100011000100011001
101110000100010000000000000011
101001110000001000011111000111
100000000100110001100010000001
101110000100010000000000000011
100110000100111000000010000011
100110000100111000000010000011
101001110000001000011111000111
100000000100110001100010000001
101110000100010000000000000011
101001110000001000011111000111
100000000111010001100010000001
101110000100010000000000000011
101001110000001000011111000111
101001110000001000011111000111
100000000110110001100010000001
101110000100010000000000000011
101001110000001000011111000111
101110000100010000000000000011
100010010010000111110000000001
111111111111111111111111111111
